X F=               X
====                
                    
*==================#
*=*  *   * *   ***= 
 =*  *   * *     *= 
 =*   * *  *   ***=!
 =*   * *  *     *= 
 =***  *   *** ***= 
 ==================#
               =    
============== =    
             =      
             =#=    
             =*=**  
             =*=@*  
==============*=====
X   #   =  k      t 
    =   !    m     !
w   = X =           