********************
@                   
                   #
*******************F
 ==================#
 =*  *   * *   ***=#
 =*   * *  *     *= 
 =*   * *  *    * =#
 =***  *   *** ***=#
 ================== 
                  =#
===================#
 =!= =!=    =!= =!= 
 =#= =#=    =#= =#= 
                    
                    
X                   
====================
    *********!!!!!!X
kmwt================